2 2 2 2 2 2 2 2 2 2 2 2 2 2 2 2 2 2 2 2 2 2 2 2 2 2 2 2 2 2 2 2 
2 0 0 0 0 0 0 0 0 0 0 0 0 0 0 0 0 0 0 0 0 0 0 0 0 0 0 0 0 0 0 2 
2 1 1 1 0 0 0 0 0 0 0 0 0 0 0 0 0 0 0 0 0 0 0 0 0 0 0 0 1 1 1 2 
2 0 0 0 0 0 0 0 4 4 4 4 0 4 0 0 0 4 0 4 4 4 0 0 0 0 0 0 0 0 0 2 
2 0 0 0 0 0 0 0 2 0 0 0 0 2 4 0 0 2 0 2 0 0 4 0 0 0 0 0 0 0 0 2 
2 0 0 0 0 0 0 0 2 0 0 0 0 2 0 4 0 2 0 2 0 0 0 4 0 0 0 0 0 0 0 2 
2 0 0 0 0 0 0 0 2 4 4 4 0 2 0 2 0 2 0 2 0 0 0 2 0 0 0 0 0 0 0 2 
2 0 0 0 0 0 0 0 2 0 0 0 0 2 0 2 0 2 0 2 0 0 0 2 0 0 0 0 0 0 0 2 
2 0 0 0 0 0 0 0 2 0 0 0 0 2 0 0 4 2 0 2 0 0 4 0 0 0 0 0 0 0 0 2 
2 0 0 0 0 0 0 0 2 4 4 4 0 2 0 0 0 2 0 2 4 4 0 0 0 0 0 0 0 0 0 2 
2 0 0 0 0 0 0 0 0 0 0 0 0 0 0 0 0 0 0 0 0 0 0 0 0 0 0 0 0 0 0 2 
2 0 0 0 0 0 0 0 0 0 0 0 0 0 0 0 0 0 0 0 0 0 0 0 0 0 0 0 0 0 0 2 
2 0 0 0 0 0 0 0 0 0 0 0 0 0 0 0 0 0 0 0 0 0 0 0 0 0 0 0 0 0 0 2 
2 0 0 0 0 0 0 0 0 0 0 0 0 0 0 0 0 0 0 0 0 0 0 0 0 0 0 0 0 0 0 2 
2 0 0 0 0 0 0 0 0 0 0 0 0 0 0 0 0 0 0 0 0 0 0 0 0 0 0 0 0 0 0 2 
2 0 0 0 0 0 0 0 0 0 0 0 0 0 0 0 0 0 0 0 0 0 0 0 0 0 0 0 0 0 0 2 
2 0 0 0 0 0 0 0 0 0 0 0 0 0 0 0 0 0 0 0 0 0 0 0 0 0 0 0 0 0 0 2 
2 0 0 0 0 0 0 0 0 0 0 0 0 0 0 0 0 0 0 0 0 0 0 0 0 0 0 0 0 0 0 2 
2 0 0 0 0 0 0 0 0 0 0 0 0 0 0 0 0 0 0 0 0 0 0 0 0 0 0 0 0 0 0 2 
2 4 4 4 4 4 4 4 4 4 4 4 4 4 4 4 4 4 4 4 4 4 4 4 4 4 4 4 4 4 4 2      
22 7
./sprites/playerOne.png 31 2
./sprites/playerTwo.png 2 2
3 4 0 0 1
6 3 0 0 1
4 15 0 0 1
7 15 0 0 1
26 3 0 0 1
29 4 0 0 1
25 15 0 0 1
28 15 0 0 1
