2 2 2 2 2 2 2 2 2 2 2 2 2 2 2 2 2 2 2 2 2 2 2 2 2 2 2 2 2 2 2 2 
2 0 0 0 0 0 0 0 0 0 0 0 0 0 2 0 0 0 0 0 0 0 0 0 0 0 0 0 0 0 0 2 
2 0 0 0 0 0 0 0 0 0 0 0 0 0 2 0 0 0 0 0 0 0 0 0 0 0 0 0 0 0 0 2 
2 0 0 0 1 1 1 1 1 1 0 0 0 0 2 0 0 1 1 1 1 1 0 0 0 0 0 0 0 0 0 2 
2 0 0 0 0 0 0 0 0 2 0 0 0 0 2 0 0 2 2 2 2 2 1 1 1 1 1 1 0 0 0 2 
2 0 1 0 0 0 0 0 0 2 0 0 0 0 2 0 0 2 2 2 2 0 0 0 0 0 0 0 0 0 0 2 
2 0 0 0 0 0 0 0 0 2 0 0 0 0 2 0 0 2 2 2 0 0 0 0 0 0 0 0 0 0 0 2 
2 0 0 0 0 0 0 0 0 2 0 0 0 0 2 0 0 2 2 0 0 0 0 0 0 0 0 0 1 1 1 2 
2 1 0 0 0 0 0 0 0 2 1 4 4 1 2 0 0 2 2 0 0 0 0 0 0 0 0 0 0 0 0 2 
2 0 0 0 0 0 0 0 0 0 0 0 0 0 2 0 0 2 2 0 0 0 0 0 0 0 0 0 0 0 0 2 
2 0 0 0 0 0 0 0 0 0 0 0 0 0 2 0 0 2 2 1 0 0 0 0 1 1 1 1 0 0 0 2 
2 0 1 0 0 0 0 0 0 0 0 0 0 0 2 0 0 2 0 2 1 0 0 0 0 0 0 0 0 0 0 2 
2 0 0 0 0 0 0 0 0 0 0 0 0 0 2 0 0 2 0 0 2 1 0 0 0 0 0 0 0 0 0 2 
2 0 0 0 0 0 0 0 0 0 0 0 0 0 2 0 0 2 0 0 0 2 1 0 0 0 0 0 1 1 1 2 
2 1 1 1 0 0 1 1 0 0 0 0 0 0 2 0 0 2 0 0 0 0 2 1 0 0 0 0 0 0 0 2 
2 0 0 0 0 0 0 2 0 0 0 0 0 0 0 0 0 2 0 0 0 0 0 2 1 0 0 0 0 0 0 2 
2 0 0 0 0 0 0 2 1 3 3 1 0 0 0 0 0 2 0 0 0 0 0 0 2 1 1 1 0 0 0 2 
2 0 0 0 0 0 0 0 2 2 2 2 1 1 1 1 1 2 0 0 0 0 0 0 0 0 0 0 0 0 0 2 
2 0 0 0 0 0 0 0 0 0 0 0 0 0 0 0 0 0 0 0 0 0 0 0 0 0 0 0 0 0 0 2 
2 1 1 1 1 1 1 1 1 1 1 1 1 1 1 1 1 1 1 1 1 1 1 1 1 1 1 1 1 1 1 2  
5 17
./sprites/playerOne.png 3 19
./sprites/playerTwo.png 2 19
16 4 0 1 1
16 12 0 1 0
10 10 3 1 1

//cloud x, y, movement, dir, raining
