2 2 2 2 2 2 2 2 2 2 2 2 2 2 2 2 2 2 2 2 2 2 2 2 2 2 2 2 2 2 2 2 
2 0 0 0 0 0 0 2 0 0 0 0 0 0 0 2 2 0 0 0 0 0 0 0 2 0 0 0 0 0 0 2 
2 0 0 0 0 0 0 2 0 0 0 0 0 0 0 2 2 0 0 0 0 0 0 0 2 0 0 0 0 0 0 2 
2 1 1 1 1 0 0 2 0 0 1 1 1 0 0 2 2 0 0 1 1 1 0 0 2 0 0 1 1 1 1 2 
2 0 0 0 0 0 0 2 0 0 0 0 2 0 1 2 2 1 0 2 0 0 0 0 2 0 0 0 0 0 0 2 
2 0 0 0 0 0 0 2 0 0 0 0 2 0 0 2 2 0 0 2 0 0 0 0 2 0 0 0 0 0 0 2 
2 0 0 1 1 1 1 2 1 1 0 0 2 1 0 2 2 0 1 2 0 0 1 1 2 1 1 1 1 0 0 2 
2 0 0 0 0 0 0 0 0 0 0 0 2 0 0 2 2 0 0 2 0 0 0 0 0 0 0 0 0 0 0 2 
2 0 0 0 0 0 0 0 0 0 0 0 2 0 1 2 2 1 0 2 0 0 0 0 0 0 0 0 0 0 0 2 
2 0 0 0 0 0 0 0 0 0 1 1 2 0 0 2 2 0 0 2 1 1 0 0 0 0 0 0 0 0 0 2 
2 0 0 0 0 0 0 0 0 0 0 0 2 1 0 2 2 0 1 2 0 0 0 0 0 0 0 0 0 0 0 2 
2 0 0 0 0 0 0 0 0 0 0 0 2 0 0 2 2 0 0 2 0 0 0 0 0 0 0 0 0 0 0 2 
2 1 3 3 1 1 1 1 1 1 1 1 2 0 0 2 2 0 0 2 1 1 1 1 1 1 1 1 3 3 1 2 
2 0 0 0 0 0 0 0 0 0 0 0 0 0 0 2 2 0 0 0 0 0 0 0 0 0 0 0 0 0 0 2 
2 0 0 0 0 0 0 0 0 0 0 0 0 0 0 2 2 0 0 0 0 0 0 0 0 0 0 0 0 0 0 2 
2 0 0 0 0 0 0 1 1 1 3 3 1 1 1 2 2 1 1 1 3 3 1 1 1 0 0 0 0 0 0 2 
2 0 0 0 0 0 1 2 0 2 0 0 0 2 0 0 0 0 2 0 0 0 2 0 2 1 0 0 0 0 0 2 
2 0 0 0 0 1 2 0 0 2 0 0 0 2 0 0 0 0 2 0 0 0 2 0 0 2 1 0 0 0 0 2 
2 0 0 0 0 0 0 0 0 2 0 0 0 2 0 0 0 0 2 0 0 0 2 0 0 0 0 0 0 0 0 2 
2 1 4 4 1 1 1 1 1 1 1 1 1 1 1 1 1 1 1 1 1 1 1 1 1 1 1 1 4 4 1 2   
100 100
./sprites/playerOne.png 31 3
./sprites/playerTwo.png 2 3
5 8 3 1 1
27 8 3 -1 1
